# elem, crate, module, channel
0   7   0   0
1   7   0   1
2   7   0   2
3   7   0   3
4   7   0   4
5   7   0   5
6   7   0   6
7   7   0   7
8   7   1   0
9   7   1   1
10  7   1   2
11  7   1   3
12  7   1   4
13  7   1   5
14  7   1   6
15  7   1   7
16  7   2   0
17  7   2   1
18  7   2   2
19  7   2   3
20  7   2   4
21  7   2   5
22  7   2   6
23  7   2   7
24  7   3   0
25  7   3   1
26  7   3   2
27  7   3   3
28  7   3   4
29  7   3   5
30  7   3   6
31  7   3   7
32  7   4   0
33  7   4   1
34  7   4   2
35  7   4   3
36  7   4   4
37  7   4   5
38  7   4   6
39  7   4   7
40  7   5   0
41  7   5   1
42  7   5   2
43  7   5   3
44  7   5   4
45  7   5   5
46  7   5   6
47  7   5   7
48  7   6   0
49  7   6   1
50  7   6   2
51  7   6   3
52  7   6   4
53  7   6   5
54  7   6   6
55  7   6   7
56  7   7   0
57  7   7   1
58  7   7   2
59  7   7   3
60  7   7   4
61  7   7   5
62  7   7   6
63  7   7   7
64  7   8   0
65  7   8   1
66  7   8   2
67  7   8   3
68  7   8   4
69  7   8   5
70  7   8   6
71  7   8   7
72  7   9   0
73  7   9   1
74  7   9   2
75  7   9   3
76  7   9   4
77  7   9   5
78  7   9   6
79  7   9   7
80  7   10  0
81  7   10  1
82  7   10  2
83  7   10  3
84  7   10  4
85  7   10  5
86  7   10  6
87  7   10  7
88  7   11  0
89  7   11  1
90  7   11  2
91  7   11  3
92  7   11  4
93  7   11  5
94  7   11  6
95  7   11  7
96  7   12  0
97  7   12  1
98  7   12  2
99  7   12  3
100 7   12  4
101 7   12  5
102 7   12  6
103 7   12  7
104 7   13  0
105 7   13  1
106 7   13  2
107 7   13  3
108 7   13  4
109 7   13  5
110 7   13  6
111 7   13  7
112 7   14  0
113 7   14  1
114 7   14  2
115 7   14  3
116 7   14  4
117 7   14  5
118 7   14  6
119 7   14  7
120 7   15  0
121 7   15  1
122 7   15  2
123 7   15  3
124 7   15  4
125 7   15  5
126 7   15  6
127 7   15  7
128 8   0   0
129 8   0   1
130 8   0   2
131 8   0   3
132 8   0   4
133 8   0   5
134 8   0   6
135 8   0   7
136 8   1   0
137 8   1   1
138 8   1   2
139 8   1   3
140 8   1   4
141 8   1   5
142 8   1   6
143 8   1   7
144 8   2   0
145 8   2   1
146 8   2   2
147 8   2   3
148 8   2   4
149 8   2   5
150 8   2   6
151 8   2   7
152 8   3   0
153 8   3   1
154 8   3   2
155 8   3   3
156 8   3   4
157 8   3   5
158 8   3   6
159 8   3   7
160 8   4   0
161 8   4   1
162 8   4   2
163 8   4   3
164 8   4   4
165 8   4   5
166 8   4   6
167 8   4   7
168 8   5   0
169 8   5   1
170 8   5   2
171 8   5   3
172 8   5   4
173 8   5   5
174 8   5   6
175 8   5   7
176 8   6   0
177 8   6   1
178 8   6   2
179 8   6   3
180 8   6   4
181 8   6   5
182 8   6   6
183 8   6   7
184 8   7   0
185 8   7   1
186 8   7   2
187 8   7   3
188 8   7   4
189 8   7   5
190 8   7   6
191 8   7   7
192 8   8   0
193 8   8   1
194 8   8   2
195 8   8   3
196 8   8   4
197 8   8   5
198 8   8   6
199 8   8   7
200 8   9   0
201 8   9   1
202 8   9   2
203 8   9   3
204 8   9   4
205 8   9   5
206 8   9   6
207 8   9   7
208 8   10  0
209 8   10  1
210 8   10  2
211 8   10  3
212 8   10  4
213 8   10  5
214 8   10  6
215 8   10  7
216 8   11  0
217 8   11  1
218 8   11  2
219 8   11  3
220 8   11  4
221 8   11  5
222 8   11  6
223 8   11  7
224 8   12  0
225 8   12  1
226 8   12  2
227 8   12  3
228 8   12  4
229 8   12  5
230 8   12  6
231 8   12  7
232 8   13  0
233 8   13  1
234 8   13  2
235 8   13  3
236 8   13  4
237 8   13  5
238 8   13  6
239 8   13  7
240 8   14  0
241 8   14  1
242 8   14  2
243 8   14  3
244 8   14  4
245 8   14  5
246 8   14  6
247 8   14  7
248 8   15  0
249 8   15  1
250 8   15  2
251 8   15  3
252 8   15  4
253 8   15  5
254 8   15  6
255 8   15  7
256 9   0   0
257 9   0   1
258 9   0   2
259 9   0   3
260 9   0   4
261 9   0   5
262 9   0   6
263 9   0   7
264 9   1   0
265 9   1   1
266 9   1   2
267 9   1   3
268 9   1   4
269 9   1   5
270 9   1   6
271 9   1   7
272 9   2   0
273 9   2   1
274 9   2   2
275 9   2   3
276 9   2   4
277 9   2   5
278 9   2   6
279 9   2   7
280 9   3   0
281 9   3   1
282 9   3   2
283 9   3   3
284 9   3   4
285 9   3   5
286 9   3   6
287 9   3   7
288 9   4   0
289 9   4   1
290 9   4   2
291 9   4   3
292 9   4   4
293 9   4   5
294 9   4   6
295 9   4   7
296 9   5   0
297 9   5   1
298 9   5   2
299 9   5   3
300 9   5   4
301 9   5   5
302 9   5   6
303 9   5   7
304 9   6   0
305 9   6   1
306 9   6   2
307 9   6   3
308 9   6   4
309 9   6   5
310 9   6   6
311 9   6   7
312 9   7   0
313 9   7   1
314 9   7   2
315 9   7   3
316 9   7   4
317 9   7   5
318 9   7   6
319 9   7   7
320 9   8   0
321 9   8   1
322 9   8   2
323 9   8   3
324 9   8   4
325 9   8   5
326 9   8   6
327 9   8   7
328 9   9   0
329 9   9   1
330 9   9   2
331 9   9   3
332 9   9   4
333 9   9   5
334 9   9   6
335 9   9   7
336 9   10  0
337 9   10  1
338 9   10  2
339 9   10  3
340 9   10  4
341 9   10  5
342 9   10  6
343 9   10  7
344 9   11  0
345 9   11  1
346 9   11  2
347 9   11  3
348 9   11  4
349 9   11  5
350 9   11  6
351 9   11  7
352 9   12  0
353 9   12  1
354 9   12  2
355 9   12  3
356 9   12  4
357 9   12  5
358 9   12  6
359 9   12  7
360 9   13  0
361 9   13  1
362 9   13  2
363 9   13  3
364 9   13  4
365 9   13  5
366 9   13  6
367 9   13  7
368 9   14  0
369 9   14  1
370 9   14  2
371 9   14  3
372 9   14  4
373 9   14  5
374 9   14  6
375 9   14  7
376 9   15  0
377 9   15  1
378 9   15  2
379 9   15  3
380 9   15  4
381 9   15  5
382 9   15  6
383 9   15  7
