# elem, crate, module, channel
0   1   0   0
1   1   0   1
2   1   0   2
3   1   0   3
4   1   1   0
5   1   1   1
6   1   1   2
7   1   1   3
8   1   2   0
9   1   2   1
10  1   2   2
11  1   2   3
12  1   3   0
13  1   3   1
14  1   3   2
15  1   3   3
16  1   4   0
17  1   4   1
18  1   4   2
19  1   4   3
20  1   5   0
21  1   5   1
22  1   5   2
23  1   5   3
24  1   6   0
25  1   6   1
26  1   6   2
27  1   6   3
28  1   7   0
29  1   7   1
30  1   7   2
31  1   7   3
32  1   8   0
33  1   8   1
34  1   8   2
35  1   8   3
36  1   9   0
37  1   9   1
38  1   9   2
39  1   9   3
40  1   10  0
41  1   10  1
42  1   10  2
43  1   10  3
44  1   11  0
45  1   11  1
46  1   11  2
47  1   11  3
48  1   12  0
49  1   12  1
50  1   12  2
51  1   12  3
52  1   13  0
53  1   13  1
54  1   13  2
55  1   13  3
56  1   14  0
57  1   14  1
58  1   14  2
59  1   14  3
60  1   15  0
61  1   15  1
62  1   15  2
63  1   15  3
64  2   0   0
65  2   0   1
66  2   0   2
67  2   0   3
68  2   1   0
69  2   1   1
70  2   1   2
71  2   1   3
72  2   2   0
73  2   2   1
74  2   2   2
75  2   2   3
76  2   3   0
77  2   3   1
78  2   3   2
79  2   3   3
80  2   4   0
81  2   4   1
82  2   4   2
83  2   4   3
84  2   5   0
85  2   5   1
86  2   5   2
87  2   5   3
88  2   6   0
89  2   6   1
90  2   6   2
91  2   6   3
92  2   7   0
93  2   7   1
94  2   7   2
95  2   7   3
96  2   8   0
97  2   8   1
98  2   8   2
99  2   8   3
100 2   9   0
101 2   9   1
102 2   9   2
103 2   9   3
104 2   10  0
105 2   10  1
106 2   10  2
107 2   10  3
108 2   11  0
109 2   11  1
110 2   11  2
111 2   11  3
112 2   12  0
113 2   12  1
114 2   12  2
115 2   12  3
116 2   13  0
117 2   13  1
118 2   13  2
119 2   13  3
120 2   14  0
121 2   14  1
122 2   14  2
123 2   14  3
124 2   15  0
125 2   15  1
126 2   15  2
127 2   15  3
128 3   0   0
129 3   0   1
130 3   0   2
131 3   0   3
132 3   1   0
133 3   1   1
134 3   1   2
135 3   1   3
136 3   2   0
137 3   2   1
138 3   2   2
139 3   2   3
140 3   3   0
141 3   3   1
142 3   3   2
143 3   3   3
144 3   4   0
145 3   4   1
146 3   4   2
147 3   4   3
148 3   5   0
149 3   5   1
150 3   5   2
151 3   5   3
152 3   6   0
153 3   6   1
154 3   6   2
155 3   6   3
156 3   7   0
157 3   7   1
158 3   7   2
159 3   7   3
160 3   8   0
161 3   8   1
162 3   8   2
163 3   8   3
164 3   9   0
165 3   9   1
166 3   9   2
167 3   9   3
168 3   10  0
169 3   10  1
170 3   10  2
171 3   10  3
172 3   11  0
173 3   11  1
174 3   11  2
175 3   11  3
176 3   12  0
177 3   12  1
178 3   12  2
179 3   12  3
180 3   13  0
181 3   13  1
182 3   13  2
183 3   13  3
184 3   14  0
185 3   14  1
186 3   14  2
187 3   14  3
188 3   15  0
189 3   15  1
190 3   15  2
191 3   15  3
192 4   0   0
193 4   0   1
194 4   0   2
195 4   0   3
196 4   1   0
197 4   1   1
198 4   1   2
199 4   1   3
200 4   2   0
201 4   2   1
202 4   2   2
203 4   2   3
204 4   3   0
205 4   3   1
206 4   3   2
207 4   3   3
208 4   4   0
209 4   4   1
210 4   4   2
211 4   4   3
212 4   5   0
213 4   5   1
214 4   5   2
215 4   5   3
216 4   6   0
217 4   6   1
218 4   6   2
219 4   6   3
220 4   7   0
221 4   7   1
222 4   7   2
223 4   7   3
224 4   8   0
225 4   8   1
226 4   8   2
227 4   8   3
228 4   9   0
229 4   9   1
230 4   9   2
231 4   9   3
232 4   10  0
233 4   10  1
234 4   10  2
235 4   10  3
236 4   11  0
237 4   11  1
238 4   11  2
239 4   11  3
240 4   12  0
241 4   12  1
242 4   12  2
243 4   12  3
244 4   13  0
245 4   13  1
246 4   13  2
247 4   13  3
248 4   14  0
249 4   14  1
250 4   14  2
251 4   14  3
252 4   15  0
253 4   15  1
254 4   15  2
255 4   15  3
256 5   0   0
257 5   0   1
258 5   0   2
259 5   0   3
260 5   1   0
261 5   1   1
262 5   1   2
263 5   1   3
264 5   2   0
265 5   2   1
266 5   2   2
267 5   2   3
268 5   3   0
269 5   3   1
270 5   3   2
271 5   3   3
272 5   4   0
273 5   4   1
274 5   4   2
275 5   4   3
276 5   5   0
277 5   5   1
278 5   5   2
279 5   5   3
280 5   6   0
281 5   6   1
282 5   6   2
283 5   6   3
284 5   7   0
285 5   7   1
286 5   7   2
287 5   7   3
288 5   8   0
289 5   8   1
290 5   8   2
291 5   8   3
292 5   9   0
293 5   9   1
294 5   9   2
295 5   9   3
296 5   10  0
297 5   10  1
298 5   10  2
299 5   10  3
300 5   11  0
301 5   11  1
302 5   11  2
303 5   11  3
304 5   12  0
305 5   12  1
306 5   12  2
307 5   12  3
308 5   13  0
309 5   13  1
310 5   13  2
311 5   13  3
312 5   14  0
313 5   14  1
314 5   14  2
315 5   14  3
316 5   15  0
317 5   15  1
318 5   15  2
319 5   15  3
320 6   0   0
321 6   0   1
322 6   0   2
323 6   0   3
324 6   1   0
325 6   1   1
326 6   1   2
327 6   1   3
328 6   2   0
329 6   2   1
330 6   2   2
331 6   2   3
332 6   3   0
333 6   3   1
334 6   3   2
335 6   3   3
336 6   4   0
337 6   4   1
338 6   4   2
339 6   4   3
340 6   5   0
341 6   5   1
342 6   5   2
343 6   5   3
344 6   6   0
345 6   6   1
346 6   6   2
347 6   6   3
348 6   7   0
349 6   7   1
350 6   7   2
351 6   7   3
352 6   8   0
353 6   8   1
354 6   8   2
355 6   8   3
356 6   9   0
357 6   9   1
358 6   9   2
359 6   9   3
360 6   10  0
361 6   10  1
362 6   10  2
363 6   10  3
364 6   11  0
365 6   11  1
366 6   11  2
367 6   11  3
368 6   12  0
369 6   12  1
370 6   12  2
371 6   12  3
372 6   13  0
373 6   13  1
374 6   13  2
375 6   13  3
376 6   14  0
377 6   14  1
378 6   14  2
379 6   14  3
380 6   15  0
381 6   15  1
382 6   15  2
383 6   15  3
